1111111111111111
1111111111111111
2#2#2      2#2#2
22222  ##  22222
33333  ##  33333
3#3#3      3#3#3
4444444444444444
4444444444444444