1212121212121
2222222222222
2131412141312
2334422244332
2131412141312
2233442443322