###############
# 44 44 44 44 #
#4444444444444#
# 33 33 33 33 #
#3333333333333#
# 22 22 22 22 #
#2222222222222#
# ## ## ## ## #